border_size=1
usage=map

Mm^Xm       , Mm^Xm       , Mm^Xm       , Mm^Xm       , Mm^Xm       , Mm^Xm       , Mm^Xm       , Mm^Xm       , Mm^Xm       , Mm^Xm       , Mm^Xm       , Mm^Xm       , Mm^Xm       , Mm^Xm       , Mm^Xm       , Mm^Xm       , Mm          , Mm^Xm       , Mm^Xm       , Mm^Xm       , Mm^Xm       , Mm^Xm       , Mm          , Mm^Xm       , Mm^Xm       , Mm^Xm       , Mm          , Mm          , Mm          , Mm^Xm       , Rd          , Rd          , Mm          , Mm          , Mm          
Mm^Xm       , Mm^Xm       , Mm^Xm       , Mm^Xm       , Mm^Xm       , Mm^Xm       , Mm^Xm       , Mm^Xm       , Mm^Xm       , Mm^Xm       , Mm^Xm       , Mm^Xm       , Mm^Xm       , Mm^Xm       , Mm^Xm       , Mm^Xm       , Mm^Xm       , Mm^Xm       , Mm^Xm       , Mm^Xm       , Mm          , Mm          , Mm          , Mm          , Mm          , Mm          , Mm          , Hh          , Rd          , Rd          , Hh          , Hh          , Hh          , Mm          , Mm          
Mm^Xm       , Mm^Xm       , Mm^Xm       , Mm^Xm       , Mm^Xm       , Mm^Xm       , Mm^Xm       , Mm^Xm       , Mm^Xm       , Mm^Xm       , Mm^Xm       , Mm^Xm       , Mm^Xm       , Mm^Xm       , Mm          , Mm          , Mm          , Mm^Xm       , Mm          , Mm          , Mm          , Mm          , Mm          , Mm          , Hh          , Mm          , Rd          , Rd          , Hh          , Hh          , Hh          , Mm          , Mm          , Hh          , Mm          
Mm^Xm       , Mm^Xm       , Mm^Xm       , Mm^Xm       , Mm^Xm       , Mm^Xm       , Mm^Xm       , Mm^Xm       , Mm^Xm       , Mm^Xm       , Mm^Xm       , Mm^Xm       , Mm          , Mm          , Mm          , Mm          , Mm          , Mm          , Mm          , Mm          , Mm          , Mm          , Mm          , Hh          , Rd          , Rd          , Hh^Fmf      , Hh          , Mm          , Hh          , Mm          , Hh          , Hh          , Hh          , Mm          
Mm^Xm       , Mm^Xm       , Mm^Xm       , Mm^Xm       , Mm^Xm       , Mm^Xm       , Mm^Xm       , Mm^Xm       , Mm^Xm       , Mm^Xm       , Mm^Xm       , Mm^Xm       , Mm          , Mm          , Mm          , Mm          , Mm          , Mm          , Mm          , Mm          , Hh          , Mm          , Rd          , Rd          , Hh          , Hh          , Hh^Fmf      , Hh          , Hh          , Hh          , Hh          , Hh          , Hh          , Mm          , Mm          
Mm^Xm       , Mm^Xm       , Mm^Xm       , Mm^Xm       , Mm^Xm       , Mm^Xm       , Mm^Xm       , Mm^Xm       , Mm^Xm       , Mm^Xm       , Mm          , Mm^Xm       , Mm          , Mm          , Ww          , Mm          , Mm          , Mm          , Mm          , Mm          , Rd          , Rd          , Hh          , Hh          , Gg          , Hh          , Hh          , Mm          , Hh^Fmw      , Mm          , Hh^Fmf      , Hh^Fmf      , Hh^Fmf      , Hh          , Mm          
Mm^Xm       , Mm^Xm       , Mm^Xm       , Mm^Xm       , Mm^Xm       , Mm^Xm       , Mm^Xm       , Mm^Xm       , Mm^Xm       , Mm^Xm       , Mm^Xm       , Mm          , Mm          , Ww          , Hh^Fmw      , Mm          , Hh^Fmw      , Hh^Fmw      , Rd          , Rd          , Hh          , Hh          , Gg          , Gg          , Gg          , Gg          , Gs^Fdw      , Hh^Fmw      , Hh^Fmw      , Hh          , Hh          , Hh          , Hh          , Hh          , Mm          
Mm^Xm       , Mm^Xm       , Mm^Xm       , Mm^Xm       , Mm^Xm       , Mm^Xm       , Mm^Xm       , Mm^Xm       , Mm          , Mm          , Mm          , Mm          , Hh          , Hh          , Hh          , Hh^Fmw      , Rd          , Rd          , Gs^Fmw      , Hh          , Gg          , Gg          , Gg          , Gg          , Gs^Fdw      , Gs^Fdw      , Gs^Fdw      , Gs^Fdw      , Gs^Fdw      , Gs^Fdw      , Hh          , Hh          , Hh          , Hh          , Mm          
Mm^Xm       , Mm^Xm       , Mm^Xm       , Mm^Xm       , Mm^Xm       , Mm^Xm       , Mm^Xm       , Mm          , Mm          , Mm          , Hh          , Mm          , Hh          , Hh          , Gs^Fmw      , Rd          , Gs^Fmw      , Gs^Fmw      , Gs^Fmw      , Gs^Fmw      , Gg          , Gg          , Gg          , Gg          , Gs^Fdw      , Gs^Fdw      , Gs^Fdw      , Uu^Uf       , Ss          , Gs^Fdw      , Uu^Uf       , Hh          , Hh          , Hh          , Mm          
Mm^Xm       , Mm^Xm       , Mm^Xm       , Mm^Xm       , Mm^Xm       , Mm          , Mm          , Mm          , Hh          , Mm          , Hh          , Hh          , Hh          , Gs^Fmw      , Gg          , Rd          , Gs^Fmw      , Gs^Fmw      , Gg          , Gg          , Gg          , Gg          , Gg          , Gg          , Uu^Uf       , Gs^Fdw      , Ss          , Ss          , Ww          , Ss          , Uu^Uf       , Ggf         , Ggf         , Hh          , Hh          
Mm          , Mm^Xm       , Mm^Xm       , Mm          , Mm          , Mm          , Mm          , Hh          , Hh          , Hh          , Gg          , Gg          , Gg          , Gg          , Gg          , Rd          , Gg          , Gg          , Gg          , Gg          , Gg          , Gg          , Gg          , Gg          , Gs^Fmf      , Ss          , Ww          , Ss          , Ss          , Ss          , Hh          , Ggf         , Ggf         , Hh          , Mm          
Mm^Xm       , Mm^Xm       , Mm          , Mm          , Ww          , Hh          , Hh          , Mm          , Hh          , Gs^Fdf      , Gg          , Gg^Fet      , Gg          , Gg          , Gg          , Rd          , Gg          , Gg          , Gg          , Gg          , Gg          , Gg          , Hh^Fmf      , Gs^Fmf      , Gs^Fmf      , Ss          , Ss          , Ss          , Ss          , Ss          , Uu^Uf       , Ggf         , Ggf         , Ggf         , Mm          
Mm^Xm       , Mm          , Mm          , Mm          , Ww          , Hh          , Mm          , Hh          , Gs^Fdf      , Gs^Fdf      , Gg          , Gg          , Gg          , Gg          , Gg          , Rd          , Gg          , Gg          , Gg          , Gs^Fmf      , Gs^Fmf      , Hh^Fmf      , Hh^Fmf      , Gs^Fmf      , Gs^Fmf      , Uu^Uf       , Uu^Uf       , Ss          , Gg^Dr       , Ww          , Hh          , Hh          , Hh          , Hh          , Hh          
Mm^Xm       , Mm          , Mm          , Mm          , Mm          , Mm          , Hh          , Hh          , Hh          , Gs^Fdf      , Gg          , Gg          , Gg          , Gg          , Gg          , Rd          , Gg          , Gs^Fmf      , Gs^Fmf      , Gs^Fmf      , Hh^Fmf      , Gs^Fmf      , Gs^Fmf      , Gs^Fmf      , Gs^Fmf      , Gs^Fmf      , Gs^Fmf      , Gs^Fmf      , Gs^Fmf      , Ww          , Ww          , Hh          , Hh          , Hh          , Mm          
Mm^Xm       , Mm          , Mm          , Mm          , Mm          , Mm          , Mm          , Hh          , Gg          , Gg          , Gg          , Gg          , Gg          , Gg          , Gg          , Rd          , Gg          , Gs^Fmf      , Gs^Fmf      , Gs^Fmf      , Gs^Fmf      , Gs^Fmf      , Gs^Fmf      , Gs^Fmf      , Gs^Fmf      , Hh^Fmf      , Gs^Fmf      , Hh^Fmf      , Gs^Fmf      , Gs^Fmf      , Ww          , Hh          , Hh          , Hh          , Mm          
Mm^Xm       , Mm          , Mm          , Mm          , Mm          , Mm          , Gg          , Rd          , Gg          , Gg^Fet      , Gg          , Gg          , Gg          , Gg          , Gg          , Rd          , Gs^Fmf      , Gg          , Gs^Fmf      , Gs^Fmf      , Gs^Fmf      , Gs^Fmf      , Gs^Fmf      , Gs^Fmf      , Gs^Fmf      , Gs^Fmf      , Gs^Fmf      , Gs^Fmf      , Gs^Fmf      , Gs^Fmf      , Gg          , Ww          , Gg          , Hh          , Hh          
Mm^Xm       , Mm          , Mm          , Mm          , Mm          , Gg          , Gg          , Rd          , Rd          , Ggf         , Gg          , Gg          , Gg          , Gg          , Gg          , Rd          , Gg          , Gg          , Gs^Fmf      , Gs^Fmf      , Gs^Fmf      , Gs^Fmf      , Gs^Fmf      , Hh^Fmf      , Gs^Fmf      , Gs^Fmf      , Hh^Fmf      , Gs^Fmf      , Gs^Fmf      , Gs^Fmf      , Rd          , Ww          , Wwf         , Wwf         , Ww          
Mm^Xm       , Mm          , Mm          , Mm          , Mm          , Gg          , Gg          , Gg          , Gg          , Rd          , Rd          , Gg^Fet      , Gg          , Gg          , Rd          , Rd          , Gg          , Gg          , Gs^Fmf      , Gs^Fmf      , Gs^Fmf      , Hh^Fmf      , Gs^Fmf      , Gs^Fmf      , Gs^Fmf      , Gs^Fmf      , Gg          , Gg          , Rd          , Rd          , Wwf^Bw\     , Ww          , Ww          , Ww          , Wo          
Mm^Xm       , Mm          , Mm          , Mm          , Mm          , Mm          , Gg          , Gg^Fet      , Gg          , Gg          , Rd          , Rd          , Rd          , Rd          , Ggf         , Rd          , Gg          , Gg          , Gg          , Gg          , Gg          , Gs^Fmf      , Gg          , Gs^Fmf      , Gg          , Gg          , Rd          , Rd          , Wwf         , Wwf         , Ww          , Ww          , Ww          , Ww          , Wo          
Mm          , Mm          , Mm          , Mm          , Gg          , Gg          , Gg          , Gg          , Gg          , Gg          , Rd          , Rd          , Ggf         , Ggf         , Ggf         , Rd          , Gg^Vh       , Gg          , Gg          , Gg          , Gg          , Gg          , Gg          , Gg          , Rd          , Rd          , Gg          , Wwf         , Ww          , Ww          , Wo          , Ww          , Wo          , Wo          , Wo          
Hh^Fmf      , Gs^Fmf      , Gs^Fmf      , Gs^Fmf      , Gs^Fmf      , Gg          , Gg          , Gg^Fet      , Gg          , Gg          , Rd          , Gg^Wm       , Ggf         , Ggf         , Ggf         , Rd          , Rd          , Gg          , Gg          , Gg          , Rd          , Rd          , Rd          , Rd          , Gg          , Gg          , Gg          , Ww          , Wo          , Wo          , Wo          , Wo          , Wo          , Wo          , Wo          
Hh^Fmf      , Gs^Fmf      , Gs^Fmf      , Gs^Fmf      , Gs^Fmf      , Gs^Fmf      , Gs^Fmf      , Gg          , Re^Gvs      , Gg          , Rd          , Ggf         , Re^Gvs      , Hh^Fmf      , Ggf         , Rd          , Gg^Ve       , Rd          , Rd          , Rd          , Ggf         , Ggf         , Ggf         , Rd          , Rd          , Gg          , Gg          , Ww          , Ww          , Wo          , Wo          , Wo          , Wo          , Wo          , Wo          
Hh^Fmf      , Gs^Fmf      , Gs^Fmf      , Hh^Fmf      , Gs^Fmf      , Gs^Fmf      , Gs^Fmf      , Gg^Dr       , Re^Gvs      , Gg^Vh       , Rd          , Gg^Vh       , Ggf         , Ggf         , Rd          , Rd          , Rd          , Rd          , Rd          , Gg^Wm       , Gg^Vh       , Re^Gvs      , Gg          , Ggf         , Gg^Vh       , Rd          , Rd          , Gg          , Ww          , Wo          , Ww          , Ww          , Ww          , Wo          , Wo          
Hh^Fmf      , Hh^Fmf      , Hh^Fmf      , Gs^Fmf      , Gs^Fmf      , Gs^Fmf      , Gs^Fmf      , Gg          , Gg          , Gg          , Rd          , Ggf         , Rd          , Rd          , Gg^Fet      , Ggf         , Gg^Fet      , Gg          , Ggf         , Rd          , Rd          , Gg^Fet      , Gg          , Gg          , Ggf         , Ggf         , Rd          , Gg          , Gg          , Ww          , Gg          , Ww          , Ww          , Ww          , Wo          
Hh^Fmf      , Gs^Fmf      , Gs^Fmf      , Hh^Fmf      , Gs^Fmf      , Gs^Fmf      , Gs^Fmf      , Gg          , Gg^Fet      , Gg          , Rd          , Rd          , Rd          , Gg^Wm       , Ggf         , Ggf         , Ggf         , Ggf         , Ggf         , Gs^Fmf      , Ggf         , Rd          , Rd          , Rd          , Rd          , Rd          , Re^Gvs      , Rd          , Rd          , Gg          , Gg          , Ww          , Ww          , Ww          , Ww          
Hh^Fmf      , Gs^Fmf      , Hh^Fmf      , Gs^Fmf      , Hh^Fmf      , Gs^Fmf      , Gs^Fmf      , Gg          , Gg          , Gg          , Rd          , Gg^Fet      , Gg^Vh       , Rd          , Rd          , Ggf         , Gs^Fmf      , Gs^Fmf      , Gs^Fmf      , Ggf         , Ggf         , Gg^Vh       , Rd          , Rd          , Re^Gvs      , Re^Gvs      , Re^Gvs      , Re^Gvs      , Re^Gvs      , Rd          , Rd          , Gg          , Gg          , Gg          , Gg          
Hh^Fmf      , Gs^Fmf      , Hh^Fmf      , Gs^Fmf      , Gs^Fmf      , Gs^Fmf      , Gs^Fmf      , Gs^Fmf      , Gs^Fmf      , Gg          , Rd          , Gg          , Ggf         , Re^Gvs      , Gs^Fmf      , Rd          , Rd          , Gs^Fmf      , Gs^Fmf      , Gs^Fmf      , Rd          , Rd          , Rd          , Re^Gvs      , Re^Gvs      , Re^Gvs      , Re^Gvs      , Re^Gvs      , Re^Gvs      , Re^Gvs      , Rd          , Rd          , Gg          , Gg          , Gg          
Hh^Fmf      , Gs^Fmf      , Gs^Fmf      , Hh^Fmf      , Gs^Fmf      , Gs^Fmf      , Gs^Fmf      , Gs^Fmf      , Gg          , Gs^Fmf      , Rd          , Gg          , Gg          , Ggf         , Gs^Fmf      , Gs^Fmf      , Rd          , Gs^Fmf      , Rd          , Rd          , Re^Gvs      , Re^Gvs      , Re^Gvs      , Rd          , Rd          , Re^Gvs      , Re^Gvs      , Re^Gvs      , Rd          , Rd          , Gg          , Gg          , Gg          , Gg^Fet      , Gg          
Hh^Fmf      , Hh^Fmf      , Gs^Fmf      , Gs^Fmf      , Gs^Fmf      , Gs^Fmf      , Gs^Fmf      , Gs^Fmf      , Gg          , Gg          , Rd          , Gg          , Gg^Fet      , Gs^Fmf      , Gs^Fmf      , Gs^Fmf      , Rd          , Rd          , Re^Gvs      , Re^Gvs      , Re^Gvs      , Re^Gvs      , Re^Gvs      , Re^Gvs      , Re^Gvs      , Rd          , Rd          , Rd          , Gg          , Gg          , Gs^Fmw      , Ss          , Gg          , Gg          , Gg          
Hh^Fmf      , Hh^Fmf      , Hh^Fmf      , Gs^Fmf      , Gs^Fmf      , Gs^Fmf      , Gs^Fmf      , Gs^Fmf      , Gs^Fmf      , Gs^Fmf      , Rd          , Gg          , Gg          , Gg          , Re^Gvs      , Re^Gvs      , Re^Gvs      , Rd          , Rd          , Re^Gvs      , Re^Gvs      , Re^Gvs      , Re^Gvs      , Re^Gvs      , Rd          , Rd          , Ggf         , Ggf         , Gg          , Gg          , Gs^Fmw      , Uu^Uf       , Ss          , Gg          , Gg          
Hh^Fmf      , Gs^Fmf      , Gs^Fmf      , Gs^Fmf      , Gs^Fmf      , Gs^Fmf      , Gs^Fmf      , Gs^Fmf      , Gg          , Gs^Fmf      , Rd          , Gg          , Re^Gvs      , Re^Gvs      , Re^Gvs      , Re^Gvs      , 1 Re^Gvs    , Re^Gvs      , Re^Gvs      , Rd          , Rd          , Re^Gvs      , Rd          , Rd          , Ggf         , Gg^Fet      , Re^Gvs      , Re^Gvs      , Re^Gvs      , Gg          , Gg          , Ss          , Gg          , Gg          , Gg          
Hh^Fmf      , Gs^Fmf      , Ss          , Gs^Fmf      , Gs^Fmf      , Gs^Fmf      , Gs^Fmf      , Gs^Fmf      , Gg          , Gg          , Re^Gvs      , Rd          , Rd          , Re^Gvs      , Re^Gvs      , Re^Gvs      , Re^Gvs      , Re^Gvs      , Re^Gvs      , Re^Gvs      , Rd          , Rd          , Rd          , Ggf         , Re^Gvs      , Re^Gvs      , Re^Gvs      , Re^Gvs      , Re^Gvs      , Re^Gvs      , Re^Gvs      , Gg          , Gg          , Gg          , Hh^Fmf      
Hh^Fmf      , Hh          , Hh          , Hh          , Ss          , Gs^Fmf      , Gs^Fmf      , Gs^Fmf      , Re^Gvs      , Re^Gvs      , Re^Gvs      , Re^Gvs      , Re^Gvs      , Re          , Rd          , Re^Gvs      , Re^Gvs      , Re^Gvs      , Rd          , Rd          , Ggf         , Ggf         , Re^Gvs      , Rd          , Rd          , Re^Gvs      , Re^Gvs      , Re^Gvs      , Re^Gvs      , Re^Gvs      , Re^Gvs      , Re^Gvs      , Gs^Fmf      , Hh^Fmf      , Hh^Fmf      
Hh          , Hh          , Hh          , Hh          , Hh          , Gs^Fmf      , Gg          , Re^Gvs      , Re^Gvs      , Re^Gvs      , Re^Gvs      , Re^Gvs      , Re^Gvs      , Re^Gvs      , Gg          , Rd          , Rd          , Rd          , Ggf         , Ggf         , Re^Gvs      , Re^Gvs      , Re^Gvs      , Re^Gvs      , Re^Gvs      , Rd          , Rd          , Re^Gvs      , Re^Gvs      , Re^Gvs      , Gs^Fmf      , Gs^Fmf      , Gs^Fmf      , Hh^Fmf      , Hh^Fmf      
Mm^Xm       , Hh          , Mm^Xm       , Mm^Xm       , Hh          , Hh          , Mm          , Gg          , Gg          , Re^Gvs      , Re^Gvs      , Re^Gvs      , Gg          , Gg          , Rd          , Rd          , Gg          , Ggf         , Re^Gvs      , Re^Gvs      , Re^Gvs      , Re^Gvs      , Re^Gvs      , Re^Gvs      , Re^Gvs      , Re^Gvs      , Re^Gvs      , Rd          , Rd          , Gs^Fmf      , Gs^Fmf      , Gs^Fmf      , Gs^Fmf      , Hh^Fmf      , Hh^Fmf      
Mm^Xm       , Mm^Xm       , Mm^Xm       , Mm^Xm       , Mm^Xm       , Mm          , Mm          , Mm          , Mm          , Gg          , Hh^Fmf      , Hh^Fmf      , Hh^Fmf      , Rd          , Gg          , Gg          , Gg          , Gg          , Gg          , Re^Gvs      , Re^Gvs      , Re^Gvs      , Re^Gvs      , Re^Gvs      , Re^Gvs      , Re^Gvs      , Gg          , Gg          , Hh          , Rd          , Hh          , Gs^Fmf      , Gs^Fmf      , Hh^Fmf      , Hh^Fmf      
Mm^Xm       , Mm^Xm       , Mm^Xm       , Mm^Xm       , Mm^Xm       , Mm^Xm       , Mm^Xm       , Mm          , Mm          , Mm          , Hh^Fmf      , Hh^Fmf      , Hh          , Hh          , Hh          , Hh          , Hh          , Gg^Fet      , Gg          , Gg          , Gg          , Re^Gvs      , Re^Gvs      , Re^Gvs      , Gg          , Gg          , Mm          , Gg          , Hh          , Hh          , Hh          , Hh          , Mm          , Hh^Fmf      , Hh^Fmf      
Mm^Xm       , Mm^Xm       , Mm^Xm       , Mm^Xm       , Mm^Xm       , Mm^Xm       , Mm^Xm       , Mm^Xm       , Mm          , Mm          , Hh          , Hh          , Hh          , Hh          , Hh          , Mm          , Mm          , Hh          , Hh          , Mm          , Mm          , Hh          , Hh          , Hh          , Mm          , Mm          , Mm          , Mm          , Mm          , Ss          , Mm          , Mm          , Mm          , Mm          , Mm^Xm       
